Users	用户
Account	账户
username	用户名
Password	密码
Updates	更新
Upgrade	升级
Pool	池	存储池
Upload	上传
Save	保存
Enable	启用
Close	关闭
Check	检查
Cancel	取消
Block size	块大小
Memory	内存
CPU	处理器
Address	地址	ip 地址
Interface	接口
Log	日志
Link Aggregation	链路聚合
Mount point	挂载点
Nameserver	域名服务器
Network	网络
Hostname	域名
IP address	IP地址
Options	选项
Path	路径
Log in	登录
Mirror	镜像
Error	错误
Guest	访客
lagg	链路聚合	忘记哪里找到的了
Dataset	数据集
Warning	警告
Passphrase	密码
Proceed	继续
Service	服务
Legacy User Interface	经典用户界面
Port	端口
Tasks	任务
Groups	群组
Disk	磁盘
...	…
selected	选中的
Certificate	证书
Failed	失败
Netmask	子网掩码
Private Key	私钥
Snapshots	快照
Command	命令
